####################
####################
##. . . . . . . . ##
##. . . . . . . . ##
##. . . @ . . . . ##
##. . . . . . . . ##
##. . . . . . . . ##
####################
####################